######   ################        
#=@..#  *+.......$.....!#        
#v...+ * #`.$....,....$.#        
##### *1*#``..###+##.B..#   #####
       * #&``.#  * #....+***+.¡.#
 ##### * ###### ** ######   #.G.#
 #%$~#* *#....# |  #.``&+***+..a#
 #~%~+   +...G# *  #..``#   ##X##
 #####:  #X...##+###.$.`#     X  
    #=####XXa...,.......# #####X 
    #%%%%XXXXa.......$..+ #%%%+ 
    #####################:#####: 
                          :::::  
