######         #####
#¡%$%$      :  #..^#
#.@^=D   (**"**+..=#
#¡%$%$:::   !  #..v#
######         #####
