  ##################***||************########
  #&&GX^.@..b&X.`C/#.###|###  *     *#.."D".#
  #~~~~~~~~~~~~~~~~#.#Cabg$###|### * #..."..#
  #..".............#.#&&...XXX...#*  #......#
  #......GS....#####.###|#####...#:* #......#
###,,..........#...#.#  *  #8%$%1#: *+.PG&E.#
#(#P,...".ab...+...+.X|**  #88.11#:  #######
#"###############:#### ::######::
#%%%%%%%%v         : ::: : :::::::
##########::::::::: :   : :
