#############
#@........3.#
#.........3.#
#....C....3.#
#...b&b...3.#
#....C....3.#
#.........3.#
#........=3Θ#
############'
